111111111111
100000P00E01
1000000C0001
111111111111



101000100001
111111111111