111111111111111111111111111111
1000001100000C0000M00100000001
1000P01C0000O000000000C000M001
11100011000M000000000000000001
100000000000000000000000000001
100000000000000000000000000001
10000011000OC000000001110000C1
1000000C000000000O00E100000001
111111111111111111111111111111