1111011111
11111111C1
100000PCE1
1111011111