1111111111
11111111C0
100000PCE1
1111111111