1111011111
11111 11C1
100000PCE1
1111011111