111111111111
100000P00E01
1000000C0001

100000C0C001
111111111111