111111111111
100000P00E01
100000000001
100000C0C001
111111111111
