1111111
111111111
1PEC111
1111111
