111111111
111111P11
11E111111
1111C1111
111111111
111111111