111111111111
100000P00E01
1000000000011
100000C0C0011
1111111111111
