1111111
1111111
1PCE111
1111111
1