111111111111111111111111111111
1000001100000C0000000100000001
1000P01C00000000000000C0000001
100000110000C000000001110000C1
1000000C000000000000E100000001
111111111111111111111111111111